 #####  #####
 #     $    #
 #       .  #
 #  @       #
 #####    ###
 #   #      #
 #   #      #
 #   #      #
 #####      #
