 ###### #####
 #          #
 #          #
 #   @  .$  #
 #          #
 #          #
 ######  ####
 #    #     #
 #    #     #
 #    #     #
 ######     #
