#######
#@ $ .#
#  $ .#
#. $ .#
#######