###########
#         #
#      .  #
#         #
#         #
#  @   $  #
#         #
###########
