  #######
  #     #
  # @$. #
  #     #
  #######
