#########
#    .  #
#       #
# @   $ #
#       #
#       #
#########
