 #####  #####
 #          #
 # ######## #
 # #      # #
 # #      # #
   # @ .$ #
   #      #
 # #      # #
 # ######## #
 #          #
 #####  #####
